-2
###################################
#***   ***#           ^#       D  #
# ####### # ########## #  ###**#  #
#    #    #   ***      #**###**#  #
#    #  # # ########   #**###  #  #
#  ###  # #        #$  #       # *#
#       # # ###D## ### ######### *#
#  # F# # #*#   ##   #      #  # *#
#  *##  #*#*# # #### #  **  #  #  #
#   ##* ###*# #   F# D #### D  #  #
#  #$ #   #*# # # ## #  **  #  #  #
#         # # # # #**#      #  #  #
# ###D### # # # # #F*# ######  F  #
# #     # # #   # #### #       # *#
# # *** # # # # #      # ##    # *#
# # *F* # #   # ###### # *####^# *#
# #     # D $ #     F# # *#  #$# *#
# ####### #   ######## # ##  ### *#
#        ^#  % ***    ^#         *#
###################################