60
########
#     *#
#   %  #
#      #
########
