200
#########################
# %  #                   
#    # F  #######   $   #
# *  #    #     #       #
#    #    #     #########
# *  #    #              
#    #    #        ###### 
# *  ##D###        #     
#    $        $     #    
#    ###############    #
# $   $    F #          #
######## ####           #
#^     # #  F      ######
#      # #         #  F #
#      #D###########    #
#                       #
#      #   $   #        D
#########################